Animation director	/wiki/Animation_director
Animator	/wiki/Animator
Artisan	/wiki/Artisan
Artist	/wiki/Artist
Arts administration	/wiki/Arts_administration
Chief creative officer	/wiki/Chief_creative_officer
Colorist	/wiki/Colorist
Comic book creator	/wiki/Comic_book_creator
Coppersmith	/wiki/Coppersmith
Creative director	/wiki/Creative_director
Creative professional	/wiki/Creative_professional
Design director	/wiki/Design_director
Fashion design	/wiki/Fashion_design
Flatter	/wiki/Flatter
Floral design	/wiki/Floral_design
Food stylist	/wiki/Food_stylist
Game artist	/wiki/Game_artist
Leadman	/wiki/Leadman
Limner	/wiki/Limner
Make-up artist	/wiki/Make-up_artist
Marchand-mercier	/wiki/Marchand-mercier
Model (art)	/wiki/Model_(art)
Music artist (occupation)	/wiki/Music_artist_(occupation)
Penciller	/wiki/Penciller
Production designer	/wiki/Production_designer
Scenographer	/wiki/Scenographer
Senior media creative	/wiki/Senior_media_creative
Set decorator	/wiki/Set_decorator
Set dresser	/wiki/Set_dresser
Silversmith	/wiki/Silversmith
Teaching artist	/wiki/Teaching_artist
Visualizer (advertising)	/wiki/Visualizer_(advertising)