Ambulatory care nursing	/wiki/Ambulatory_care_nursing
Advanced practice nursing	/wiki/Advanced_practice_nurse
Cardiac nursing	/wiki/Cardiac_nursing
Cardiac catheter laboratory nursing	/wiki/Cardiac_catheter_laboratory_nursing
Medical case management	/wiki/Medical_case_management
Critical care nursing	/wiki/Critical_care_nursing
Emergency and trauma nursing	/wiki/Emergency_nursing
Faith community nursing	/wiki/Faith_community_nursing
Flight nursing	/wiki/Flight_nurse
Forensic nursing	/wiki/Forensic_nursing
Genetics nursing	/wiki/Genetics_nursing
Geriatric nursing	/wiki/Geriatric_nursing
Health visiting	/wiki/Health_visitor
Holistic nursing	/wiki/Holistic_nursing
Home health nursing	/wiki/Home_health_nursing
Hyperbaric nursing	/wiki/Hyperbaric_nursing
Legal nursing	/wiki/Legal_nurse_consultant
Maternal-child nursing	/wiki/Maternal-child_nursing
Medical-surgical nursing	/wiki/Medical-surgical_nursing
Mental health or psychiatric nursing	/wiki/Psychiatric_and_mental_health_nursing
Military and uniformed services nursing	/wiki/Military_nurse
Neonatal nursing	/wiki/Neonatal_nursing
Nursing informatics	/wiki/Nursing_informatics
Nursing management	/wiki/Nursing_management
Nursing research	/wiki/Nursing_research
Nurse midwifery	/wiki/Nurse_midwife
Obstetrical nursing	/wiki/Obstetrical_nursing
Occupational health nursing	/wiki/Occupational_health_nursing
Oncology nursing	/wiki/Oncology_nursing
Orthopaedic nursing	/wiki/Orthopaedic_nursing
Ostomy nursing	/wiki/Ostomy_nursing
Pediatric nursing	/wiki/Pediatric_nursing
Perianesthesia nursing	/wiki/Perianesthesia_nursing
Perioperative nursing	/wiki/Perioperative_nursing
Private duty nursing	/wiki/Private_duty_nursing
Psychiatric or mental health nursing	/wiki/Psychiatric_and_mental_health_nursing
Public health nursing	/wiki/Public_health_nursing
Quality improvement	/wiki/Quality_improvement
School nursing	/wiki/School_nursing
Space nursing	/wiki/Space_nursing
Surgical nursing	/wiki/Surgical_nursing
Telenursing	/wiki/Telenursing
Telephone triage nursing	/wiki/Telephone_triage_nursing
Travel nursing	/wiki/Travel_nursing
Utilization management	/wiki/Utilization_management
Wound care	/wiki/Wound_care